####----####----####----####
----------------------------
----------------------------
----------------------------
----####----####----####----
----------------------------
----------------------------
----------------------------
####----####----####----####
----------------------------
----------------------------
----------------------------
----####----####----####----
----------------------------
----------------------------
----------------------------
####----####----####----####
----------------------------
----------------------------
----------------------------